25 20
#############
#.......a...#    ########
#...........######......#
#...s.......d........c..#
#.......s...######...c..#
#...........#    #......#
#...........#    #...t..#
#k.......p..#    #......#
#####..######    ########
    #..#
    #..#
    #dd#
  ###..####
  #.......#      ######
  #...s...########....#
  #........w..........#
  #..................@#
  #...kk..########....#
  #.......#      ######
  #########
