25 20
#############
#.......a...#    ########
#...........######......#
#...s.......d........c..#
#.......s...######...c..#
#...........#    #......#
#...........#    #......#
#k..........#    #......#
#####..######    ########
    #..#
    #..#
    #..#
  ###..####
  #.......#      ######
  #...s...########....#
  #........w..........#
  #..................@#
  #.......########....#
  #.......#      ######
  #########
