25 20
#############
#...........#    ########
#...........######......#
#...s.......d........c..#
#.......s...######......#
#...........#    #......#
#...........#    #......#
#k..........#    #......#
#####..######    ########
    #..#
    #..#
    #..#
  ###..####
  #.......#       #####
  #...s...########....#
  #........w..........#
  #..................@#
  #.......########....#
  #.......#      ######
  #########
