25 20
#############
#u..........#    ########
###........######.......#
#...s.......d........c..#
#.......s...######...c..#
#...........#    #......#
#...........#    #...t..#
#k.......p..#    #......#
#####..######    ########
    #..#
    #..#
    #.d#
  ###..####
  #.......#      ######
  #...s...########....#
  #........w.....d....#
  #......s.......d...@#
  #.......########k...#
  #.......#      ######
  #########
