25 20
#############
#...........#    ########
#...........######......#
#...s.......d........c..#
#.......s...######...c..#
#...........#    #......#
#...........#    #...t..#
#k..........#    #......#
#####..######    ########
    #..#
    #..#
    #..#
  ###..####
  #.......#      ######
  #...s...#      #....#
  #.......#      #....#
  #.......#      #...@#
  #.......#      #....#
  #.......#      ######
  #########
